주심	주/VV + 시/EP + 다/EC
오심	오/VV + 시/EP + 다/EC
하심	하/VV + 시/EP + 다/EC
주시었음	주/VV + 시/EP + 다/EC
드림	드리/VV + 다/EF
안내드림	안내/NNG + 드리/VV + 다/EC
문의드림	문의/NNG + 드리/VV + 다/EC
연락키로	연락/NNG + 하/XSV + 기/ETN + 로/JKB
진행키로	진행/NNG + 하/XSV + 기/ETN + 로/JKB
종결키로	종결/NNG + 하/XSV + 기/ETN + 로/JKB
방문키로	방문/NNG + 하/XSV + 기/ETN + 로/JKB
상담키로	상담/NNG + 하/XSV + 기/ETN + 로/JKB
내방키로	내방/NNG + 하/XSV + 기/ETN + 로/JKB
원함	원하/VV + 다/EF
거주중	거주/NNG + 중/NNB
거주중방	거주/NNG + 중/NNB + 방/NNG
체납됨	체납/NNG + 되/VV + 다/EC
미납됨	미납/NNG + 되/VV + 다/EC
보증금지원형	NNG
장기안심	NNG
보증금지원형장기안심주택	보증금지원형/NNG + 장기안심/NNG
물음	물어보/VV + 시/EP + 다/EC
살	살/VV + 다/EC
달라	다르/VA + 다/EF
이심	이/VCP + 시/EP + 다/EF
고함	라고/EC + 하/VV
드림	드리/VV + 다/EF
부재중	부재/NNG + 중/NNB
하셨슴	하/VV + 었/EP + 음/EC
통보함	통보/NNG + 하/VV + 다/EF
받음	받/VV + 다/EF
가심	가/VV + 시/EP + 다/EC
총소득	총/MM + 소득/NNG
주세요	주/VV + 시/EP + 어요/EF
친구분	친구/NNP + 분/NNG
있슴	있/VA + 음/ETN
위해	위하/VV + 어/EC
주신	주/VV + 시/EP
상담시	상담/NNG + 시/EP